##############################################
#........B...................................#
#............................................#
#............................................#
#............................................#
#............................................#
#............................................#
S............................................E
#............................................#
#............................................#
#............................................#
#............................................#
#................................B...........#
#............................................#
##############################################
